15, 
5, 0, 
11, 11, 
0, 0, 0, 0, 0, 0, 0, 0, 0, 0, 0, 
0, 0, 0, 0, 0, 0, 0, 0, 0, 0, 0, 
0, 0, 2, 2, 2, 2, 2, 2, 0, 0, 0, 
0, 0, 2, 0, 0, 0, 0, 2, 0, 0, 0, 
2, 2, 2, 0, 0, 0, 0, 2, 2, 2, 0, 
0, 0, 0, 0, 2, 2, 0, 0, 1, 2, 0, 
2, 2, 2, 0, 0, 0, 0, 2, 2, 2, 0, 
0, 0, 2, 0, 0, 0, 0, 2, 0, 0, 0, 
0, 0, 2, 2, 2, 2, 2, 2, 0, 0, 0, 
0, 0, 0, 0, 0, 0, 0, 0, 0, 0, 0, 
0, 0, 0, 0, 0, 0, 0, 0, 0, 0, 0