35, 
5, 2, 
11, 11, 
0, 2, 2, 2, 2, 0, 0, 0, 0, 0, 0, 
0, 2, 0, 0, 2, 0, 0, 0, 0, 0, 0, 
0, 2, 3, 0, 2, 0, 0, 0, 0, 0, 0, 
0, 2, 0, 0, 2, 2, 2, 0, 0, 0, 0, 
2, 0, 4, 2, 2, 4, 2, 2, 2, 2, 0, 
2, 0, 0, 0, 0, 3, 4, 4, 1, 2, 0, 
2, 2, 3, 0, 0, 0, 2, 2, 2, 2, 0, 
2, 0, 0, 0, 2, 2, 2, 0, 0, 0, 0, 
2, 2, 2, 2, 0, 0, 0, 0, 0, 0, 0, 
0, 0, 0, 0, 0, 0, 0, 0, 0, 0, 0, 
0, 0, 0, 0, 0, 0, 0, 0, 0, 0, 0