35, 
6, 3, 
11, 11, 
0, 0, 0, 2, 2, 2, 2, 2, 2, 0, 0, 
0, 0, 0, 2, 0, 0, 0, 0, 2, 0, 0, 
0, 0, 0, 2, 0, 3, 0, 0, 2, 0, 0, 
0, 0, 0, 2, 2, 2, 0, 0, 2, 2, 2, 
0, 0, 0, 0, 0, 2, 4, 4, 0, 0, 2, 
0, 0, 2, 2, 2, 2, 3, 2, 2, 1, 2, 
0, 0, 2, 0, 0, 4, 0, 2, 2, 2, 2, 
0, 0, 2, 0, 3, 0, 2, 2, 0, 0, 0, 
0, 0, 2, 0, 0, 0, 2, 2, 0, 0, 0, 
0, 0, 0, 2, 2, 2, 0, 0, 0, 0, 0, 
0, 0, 0, 0, 0, 0, 0, 0, 0, 0, 0