350, 
1, 1, 
11, 11, 
2, 2, 2, 2, 2, 2, 2, 2, 2, 2, 2, 
2, 0, 0, 0, 2, 1, 2, 0, 0, 0, 2, 
2, 0, 0, 0, 2, 4, 2, 0, 0, 0, 2, 
2, 0, 2, 0, 2, 4, 2, 0, 0, 0, 2, 
2, 0, 4, 0, 0, 4, 2, 0, 0, 0, 2, 
2, 0, 3, 4, 0, 0, 2, 0, 0, 0, 2, 
2, 0, 3, 3, 3, 0, 2, 0, 0, 0, 2, 
2, 0, 0, 0, 0, 0, 2, 0, 0, 0, 2, 
2, 3, 3, 2, 2, 2, 2, 0, 0, 0, 2, 
2, 0, 0, 4, 4, 1, 2, 0, 0, 0, 2, 
2, 2, 2, 2, 2, 2, 2, 2, 2, 2, 2