35, 
5, 2, 
11, 11, 
0, 0, 0, 0, 0, 0, 0, 0, 0, 0, 0, 
0, 0, 0, 0, 0, 0, 0, 0, 0, 0, 0, 
0, 0, 2, 2, 2, 2, 2, 0, 0, 0, 0, 
0, 2, 0, 3, 0, 3, 0, 2, 0, 0, 0, 
2, 0, 0, 3, 0, 4, 3, 2, 2, 2, 2, 
2, 0, 0, 0, 3, 3, 0, 4, 4, 1, 2, 
2, 0, 0, 3, 0, 4, 3, 2, 2, 2, 2, 
0, 2, 0, 3, 0, 3, 2, 2, 0, 0, 0, 
0, 0, 2, 2, 2, 2, 2, 0, 0, 0, 0, 
0, 0, 0, 0, 0, 0, 0, 0, 0, 0, 0, 
0, 0, 0, 0, 0, 0, 0, 0, 0, 0, 0