15, 
5, 0, 
11, 11, 
0, 0, 0, 0, 0, 0, 0, 0, 0, 0, 0, 
0, 0, 0, 0, 0, 0, 0, 0, 0, 0, 0, 
0, 0, 0, 0, 2, 2, 2, 2, 0, 0, 0, 
0, 0, 0, 2, 0, 3, 0, 2, 0, 0, 0, 
2, 2, 2, 0, 3, 1, 3, 2, 0, 0, 0, 
0, 3, 4, 0, 0, 3, 0, 2, 0, 0, 0, 
2, 2, 2, 0, 0, 0, 0, 2, 0, 0, 0, 
0, 0, 0, 2, 2, 2, 2, 2, 0, 0, 0, 
0, 0, 0, 0, 0, 0, 0, 2, 0, 0, 0, 
0, 0, 0, 0, 0, 0, 0, 0, 0, 0, 0, 
0, 0, 0, 0, 0, 0, 0, 0, 0, 0, 0